#############################################
#..........................................@#
#..........................................@#
#....................................########
#..............................###..........#
#...........................................#
#.....................#######...............#
#...........................................#
#....................................########
#..........$......................#####.....#
#..............................####.........#
########..................####..............#
#..............#######......................#
#..............#............................#
#############################################