###############
#.............#
#.............#
#.............#
#.............#
#.....###.....#
#.....###.....#
#....####.....#
#.............#
#.............#
#.............#
#..#..........#
#..$..........#
#.............#
###############
