###############
#............@#
#.............#
#.#........#..#
#.............#
#.....###.....#
#.....###.....#
#....####.....#
#..........#..#
#.............#
#.....#.......#
#............##
#..#.....#...##
#..$..#......##
###############
