###############
#.............#
#.............#
#.............#
#.............#
#.@...###.....#
#.....###.....#
#....####.....#
#.............#
#.............#
#.............#
#.............#
#.............#
#.............#
###############
