###############
#.............#
#.............#
#.............#
#.............#
#.@...........#
#.....##......#
#....#.#......#
#.............#
#.............#
#.............#
#.............#
#.............#
#.............#
###############
