###############
#.............#
#.............#
#.............#
#.............#
#.............#
#.....##......#
#....#.#......#
#.............#
#.............#
#.............#
#.............#
#.............#
#.............#
###############
