###############
#.............#
#.............#
#.............#
#.............#
#.$...###.....#
#.....###.....#
#....####.....#
#.............#
#.............#
#.............#
#.............#
#.............#
#.............#
###############
