###############
#............@#
#.........#####
#.#...........#
#......#......#
#...#......#..#
#.............#
##.....S......#
#..S...#......#
#..#..........#
#.............#
#.....#.......#
#.............#
#..$..........#
###############
