###############
#............@#
#.S.......#####
#.#...........#
#......#...S..#
#...#......#..#
#.............#
##.....S......#
#..S...#......#
#..#..........#
#.............#
#.....#.......#
#.............#
#..$..........#
###############
