###############
#............@#
#.....#......##
#.#...........#
#......#......#
#..........#..#
#.........S...#
#......S..#...#
#..S..........#
#..#..........#
#......#......#
#.....#.......#
#.............#
#..$..........#
###############
