###############
#@............#
###..........##
#..####.......#
#.............#
#..........####
#......#......#
#.............#
#..S..........#
#.###........$#
#.............#
##.#####......#
#.............#
#.............#
###############
