###############
#@...........S#
###..........##
#...###.......#
#..........S..#
#..........#..#
#......#......#
#.............#
#.SSS.........#
#.###........$#
#S............#
##.#####......#
#.............#
#.............#
###############
