###############
#.......S....@#
#...S...#....##
#.####.....S..#
#..........##.#
#.............#
#.....###.....#
#.............#
##............#
#............S#
#..###.......##
#............##
#..........####
#..$...###.SSS#
###############
