###############
#............@#
#.......#....##
#.####........#
#..........##.#
#.............#
#.....###.....#
#.............#
##............#
#.............#
#..###.......##
#............##
#..........####
#..$...###....#
###############
